XXXXXXXXXXXXXXXXXXXX
X                  X
X  XXXXXXXXXXXX    X
X  X          X    X
X  X          X    X
X  X   XXXX   X    X
X  X   X  X   X    X
X  X   X  X   X    X
X  X   X  X   X    X
X  X   X  X   XXXXXX
X  X   X  X        X
X  X   X  X        X
X         XXXXXXXXXX
X                  X
XXXXXXXXXXXXXXXXXXXX
