XXXXXXXXXXXXXXXXXXXX
                   X
                   X
                   X
   XXXXXXXXXXXXX   X
   X           X   X
   X           X   X
   X   X       X   X
   X   X       X   X
   X   X       X   X
   X   XXXXXXXXX   X
   X               X
   X               X
   X               X
   XXXXXXXXXXXXXXXXX