X      XXXXXXXXXX   
X      X         X  
X      X          X 
X      X          X 
X      X          X 
X      X         X  
X      X  XXXXXXX   
X                   
X      X  XXXXXXX   
X      X         X  
X      X          X 
X      X          X 
X      X         X  
X      X        X  
XXXXXXXXXXXXXXXX