                    
                    
     XXXXXXXX       
    X         X     
   X           X    
   X  XX   XX  X    
         X          
        XXX         
   X  X     X  X    
   X   XXXXX   X    
    X         X     
     XXXXXXXXX      
                    
                    
                    