                    
                    
       XXXXXX       
     XX      XX     
  XX            XX  
  XXXXX    XXXXXXX  
  X   XX         X  
  X    XX        X  
  X     XX       X  
  X      XX         
  X                 
  X              X  
  XXXXXXXXXXXXXXXX  
                    
                    
